@#@###@@@### ## # ##    # # # ## ### #  ##   ##  #
********### #  #     #   # #    ####### # ### # ##
*#@#@@#*##   #  #####  #### ##    #  ## # # #  ###
*@##@#@*@## ## ###   # # #   ## ## # #      ##### 
1@####@**@@##    ### ##  #  ### #  ##   # ## # ###
## #  ##*#@## ###### ## #    ## # #### # #  #     
# #####@*## #######    ##   #  # # #####   ## ##  
 # #####*@# #@@@#  # ## # ####  ###  ##  ##  #  ##
# # #@@**#  ##@## #### ####    #####  #      # ###
# ##****# ####@@#@ ###    ##    ## # #   # ###  # 
##@@*##@@#@@#@@@@@@### #  ##  ###   # ## # #  ## #
#@***@##@##@#@@#@@@#    # # ###### # # #   ## #   
#@*### #@@@@#@###@ ## ##  ##   ## ## # # #####    
#@***@##@@##@@@## #     ###   #  ###    # ##   ###
####*#@#@@@@@@@@###     #  ## ## ##  ####### ## ##
# ##*#@@@####@##@@@# ###  # ###  ###  ## ## #  #  
 #@@*###@# #@@@@@@# # # # ##  ### #######  ##   ##
#@@@*@@#@##@#@#@@@@# # # #    ## ###  ## # #### # 
##@@***@##@@####@##   ## #        #  # ## ####### 
 ###@#*****###@@@##   # ##  # ## ##     ######  ##
##  ####@#*@###@@@@#  # # ###   # ## #  ######  # 
 # ### @##**## #@@## #    ##    ## ##  #### # # # 
 ##@@##@# #**@#@@@@@##  ####  # # ###### #      ##
 ##@***@@# #*#@#@@#@@@@  #  # ###  ##    ##   #   
 #@@*#****#**@@#@###@##  ## ### ####  ###  ##  # #
@#***#@@#*#*### #####      ##### ####  ##  ## ## #
2**#####@***# # # ### #  ##   ####  ####   ## ####
@@@@   ##@@@#####   ###     #    #  ## #   ###   #
  #  ##  ######    ##      ##### #  ##      ##  # 
  #### ##   ###### ##   ## # # ####### # # #  # ##
##       ## #   # ## ## ##### ##   # # # # ##    #
 # # # # ## ### # ###  # #    # #### #  ##     ###
 ##   # #####  #  # # # # ### #   #  # # # # ### #
###  ## #   #   ####  #   ####  ##     ### #  ####
   ## #  ## ###   ####  # #  #  #    #### #  #  ##
  #### #  #   #   #   ##  ## # ###  #  # #  # #  #
 #   # # ##   #   ### #### # ##   ###     ## ##   
# #####   # #   # ###  ##    #  #  # ##  #### #   
  #####   ## # ##### #   ### # #    ###  ## ######
####     #   ##  # # #   # ####     ## # #####   #
 ## #   # #  #  # ##   # ## # ###   ##### #  #### 
#     #  ####    #   ### ## ### #  ##  ## ### # # 
 # #  #  # ## ## # ####    ## #  #####     # #   #
 #  ##    # # #  # #  #  # ##  # # # #   ##     # 
## ## #  #  # #  #### ## #  ## #   ####### # #  ##
#  #  #     ### # ##     ## ####  ##  # # ###   ##
    # # #   # #   ### ##  ####    ####  ##  ##   #
####  ##   ##   ## #  ##    #   #  #    ##  ##### 
##  ## ##     #####   #  ##   ##  ## ### #    #   
# ####  ##### #  ###   #  # ### #  ####      ##  #
entrance: { i: 4, j: 0 }, exit: { i: 26, j: 0 }
Cost solution: 70
